1111111111111
10000000000C1
10E0011110011
1P0011C000001
1111111111111