11111111111111111111
1000000000000P0001C1
111111001C1000000101
1000E000100000000001
11111101110000111111
100000011C0010000001
11111111111111111111