11111111111111111111
10000000101000000001
111111001C1000000001
1000E100100000000001
11111101110000111111
100000011C00100P0001
11111111111111111111
