11111111111111111111
100000000000000000C1
111111001C111E111111
10000000100000000001
1111110111000P111111
100000011C0010000001
11111111111111111111