11111111111111111111
1000000000000E0001C1
111111001C1000000101
1000000010000P000001
11111101110000111111
100000011C0010000001
11111111111111111111