11111111111111111111
10000000001000000C01
1111110010011E111101
10000000100000000001
1111110111P000111111
10000001100010000001
11111111111111111111