11111111111111111111
10000000000000000001
10000000000000000001
1000E000000000000001
10000000000000000001
100000000C00000P0001
11111111111111111111
