11111111111111111111
10000000000000000001
10000000000C00000001
1000E000000000000001
10000000000000000001
100000C00000000P0001
11111111111111111111
